1111111111111111111111111111111111
100000C0000P000000001000000000E111
1010010100100000101001000000011111
101001001010101000100erger00010101
1000000000000000000000000000000001
1111111111111111111111111111111111
